{
    "name": "XD60 rev 3",
    "vendorProductId": 2017747811,
    "macros": ["", "", "", "", "", "", "", "", "", "", "", "", "", "", "", ""],
    "layers": [
        [
            "KC_GESC",
            "KC_1",
            "KC_2",
            "KC_3",
            "KC_4",
            "KC_5",
            "KC_6",
            "KC_7",
            "KC_8",
            "KC_9",
            "KC_0",
            "KC_MINS",
            "KC_EQL",
            "KC_BSPC",
            "KC_TAB",
            "KC_Q",
            "KC_W",
            "KC_E",
            "KC_R",
            "KC_T",
            "KC_Y",
            "KC_U",
            "KC_I",
            "KC_O",
            "KC_P",
            "KC_LBRC",
            "KC_RBRC",
            "KC_BSLS",
            "MO(1)",
            "KC_A",
            "KC_S",
            "KC_D",
            "KC_F",
            "KC_G",
            "KC_H",
            "KC_J",
            "KC_K",
            "KC_L",
            "KC_SCLN",
            "KC_QUOT",
            "KC_NO",
            "KC_ENT",
            "KC_LSFT",
            "KC_NO",
            "KC_Z",
            "KC_X",
            "KC_C",
            "KC_V",
            "KC_B",
            "KC_N",
            "KC_M",
            "KC_COMM",
            "KC_DOT",
            "KC_SLSH",
            "KC_DEL",
            "KC_UP",
            "KC_LCTL",
            "KC_LALT",
            "KC_LGUI",
            "KC_NO",
            "KC_NO",
            "KC_SPC",
            "KC_NO",
            "MT(MOD_LSFT | MOD_RSFT,KC_GRV)",
            "KC_LEFT",
            "KC_NO",
            "KC_RGUI",
            "MO(1)",
            "KC_DOWN",
            "KC_RGHT"
        ],
        [
            "KC_GRV",
            "KC_F1",
            "KC_F2",
            "KC_F3",
            "KC_F4",
            "KC_F5",
            "KC_F6",
            "KC_F7",
            "KC_F8",
            "KC_F9",
            "KC_F10",
            "KC_F11",
            "KC_F12",
            "KC_DEL",
            "KC_NO",
            "BL_DEC",
            "BL_INC",
            "BL_ON",
            "BL_OFF",
            "BL_STEP",
            "BL_BRTG",
            "KC_NO",
            "KC_NO",
            "KC_NO",
            "KC_MPLY",
            "KC_BRID",
            "KC_BRIU",
            "KC_NO",
            "MO(1)",
            "RGB_TOG",
            "RGB_MOD",
            "RGB_HUD",
            "RGB_HUI",
            "RGB_SAD",
            "RGB_SAI",
            "RGB_VAD",
            "RGB_VAI",
            "RGB_M_P",
            "KC_NO",
            "KC_NO",
            "KC_NO",
            "KC_ENT",
            "KC_LSFT",
            "KC_NO",
            "DYN_REC_START1",
            "DYN_MACRO_PLAY1",
            "DYN_REC_START2",
            "DYN_MACRO_PLAY2",
            "DYN_REC_STOP",
            "KC_NO",
            "KC_MUTE",
            "KC_VOLD",
            "KC_VOLU",
            "KC_NO",
            "KC_INS",
            "KC_PGUP",
            "KC_LCTL",
            "KC_LALT",
            "KC_LGUI",
            "KC_NO",
            "KC_NO",
            "KC_SPC",
            "KC_NO",
            "KC_RSFT",
            "KC_HOME",
            "KC_NO",
            "KC_RGUI",
            "MO(1)",
            "KC_PGDN",
            "KC_END"
        ],
        [
            "KC_TRNS",
            "KC_TRNS",
            "KC_TRNS",
            "KC_TRNS",
            "KC_TRNS",
            "KC_TRNS",
            "KC_TRNS",
            "KC_TRNS",
            "KC_TRNS",
            "KC_TRNS",
            "KC_TRNS",
            "KC_TRNS",
            "KC_TRNS",
            "KC_TRNS",
            "KC_TRNS",
            "KC_TRNS",
            "KC_TRNS",
            "KC_TRNS",
            "KC_TRNS",
            "KC_TRNS",
            "KC_TRNS",
            "KC_TRNS",
            "KC_TRNS",
            "KC_TRNS",
            "KC_TRNS",
            "KC_TRNS",
            "KC_TRNS",
            "KC_TRNS",
            "KC_TRNS",
            "KC_TRNS",
            "KC_TRNS",
            "KC_TRNS",
            "KC_TRNS",
            "KC_TRNS",
            "KC_TRNS",
            "KC_TRNS",
            "KC_TRNS",
            "KC_TRNS",
            "KC_TRNS",
            "KC_TRNS",
            "KC_TRNS",
            "KC_TRNS",
            "KC_TRNS",
            "KC_TRNS",
            "KC_TRNS",
            "KC_TRNS",
            "KC_TRNS",
            "KC_TRNS",
            "KC_TRNS",
            "KC_TRNS",
            "KC_TRNS",
            "KC_TRNS",
            "KC_TRNS",
            "KC_TRNS",
            "KC_TRNS",
            "KC_TRNS",
            "KC_TRNS",
            "KC_TRNS",
            "KC_TRNS",
            "KC_TRNS",
            "KC_TRNS",
            "KC_TRNS",
            "KC_TRNS",
            "KC_TRNS",
            "KC_TRNS",
            "KC_TRNS",
            "KC_TRNS",
            "KC_TRNS",
            "KC_TRNS",
            "KC_TRNS"
        ],
        [
            "KC_TRNS",
            "KC_TRNS",
            "KC_TRNS",
            "KC_TRNS",
            "KC_TRNS",
            "KC_TRNS",
            "KC_TRNS",
            "KC_TRNS",
            "KC_TRNS",
            "KC_TRNS",
            "KC_TRNS",
            "KC_TRNS",
            "KC_TRNS",
            "KC_TRNS",
            "KC_TRNS",
            "KC_TRNS",
            "KC_TRNS",
            "KC_TRNS",
            "KC_TRNS",
            "KC_TRNS",
            "KC_TRNS",
            "KC_TRNS",
            "KC_TRNS",
            "KC_TRNS",
            "KC_TRNS",
            "KC_TRNS",
            "KC_TRNS",
            "KC_TRNS",
            "KC_TRNS",
            "KC_TRNS",
            "KC_TRNS",
            "KC_TRNS",
            "KC_TRNS",
            "KC_TRNS",
            "KC_TRNS",
            "KC_TRNS",
            "KC_TRNS",
            "KC_TRNS",
            "KC_TRNS",
            "KC_TRNS",
            "KC_TRNS",
            "KC_TRNS",
            "KC_TRNS",
            "KC_TRNS",
            "KC_TRNS",
            "KC_TRNS",
            "KC_TRNS",
            "KC_TRNS",
            "KC_TRNS",
            "KC_TRNS",
            "KC_TRNS",
            "KC_TRNS",
            "KC_TRNS",
            "KC_TRNS",
            "KC_TRNS",
            "KC_TRNS",
            "KC_TRNS",
            "KC_TRNS",
            "KC_TRNS",
            "KC_TRNS",
            "KC_TRNS",
            "KC_TRNS",
            "KC_TRNS",
            "KC_TRNS",
            "KC_TRNS",
            "KC_TRNS",
            "KC_TRNS",
            "KC_TRNS",
            "KC_TRNS",
            "KC_TRNS"
        ]
    ],
    "encoders": []
}
